# 0表示空地，1表示墙体，2表示箱子，3表示人物出生点 -> 格式：类型+Row+Col -> 逗号分隔
row0=0,2,2,0,2,2,0,1,2,2,1,2,1,1,0,2
row1=1,2,1,0,2,1,2,2,1,2,0,0,0,2,2,0
row2=0,2,1,0,1,1,1,0,0,0,0,1,0,1,2,2
row3=0,2,0,3,0,2,2,1,1,2,2,0,0,0,0,2
row4=2,1,1,0,1,0,1,1,1,1,2,2,0,1,0,0
row5=0,0,0,2,0,2,1,1,1,1,2,2,0,1,0,1
row6=0,1,0,2,2,2,1,1,1,1,0,1,1,0,0,0
row7=2,1,1,0,2,2,0,0,2,0,0,1,0,0,2,0
row8=0,0,1,0,0,0,0,2,2,1,1,0,0,3,0,0
row9=2,2,0,0,0,1,1,0,0,0,0,0,0,0,0,0
row10=0,0,1,0,0,0,1,2,1,2,2,1,0,0,0,0
row11=0,0,1,1,0,0,0,0,0,0,1,1,0,0,0,2